111111111111111111
1CC0000000000C00P1
11110000C000011111
100000011100000001
1EC00000000000CCC1
111111111111111111
