11111111111111111111111111111
10000000000000000000000000001
1000000000011CC10011111110001
100000000011CC110011111110001
10000000011CC1100011000110001
1000000011CC11000011000110001
100000011CC110000010000110001
10000011CC1100000000011110001
1000011CC11000000000111110001
10011CCC110000000011110000001
101PCC11100000000011100010001
10111111111111100011100110001
1011111111111110001111111E001
100000000011111000CC0000000C1
11111111111111111111111111111
