1111111111111111111111
1CCC0000000000000000P1
11110000CCC00000011111
1000000111111100000001
100000000000000000CCC1
1111111000000001111111
10CCC0000000000000C001
1111111100000000011001
100000000000C000000E01
1111111111111111111111
